AND	AH N D
AND(2)	AE N D
BENCH	B EH N CH
BUMP	B AH M P
DO	D UW
DONT	D AA N T
DUSTBIN	D AH S T B IH N
FETCH	F EH CH
GET	G EH T
GET(2)	G IH T
GO	G OW
HOME	HH OW M
LISTEN	L IH S AH N
MACHINE	M AH SH IY N
NOT	N AA T
PANDU	P AE N D UW
REACH	R IY CH
SNICKERS	S N IH K ER Z
SPACE	S P EY S
TO	T UW
TO(2)	T IH
TO(3)	T AH
VENDING	V EH N D IH NG
